1111111111111111111
1E0000C000000000001
1010010100100011011
1010010010101011011
1P0000000C000000001
1111111111111111111
