111111111111111111111
1E00000000000C000C001
101001010010001001011
101001001010101001011
1P0000000C00C00000001
111111111111111111111
