1111111111111111111111111
100000000000000C00000C001
1010010100100000101001001
1010010010101010001001001
1P0000000C00C0000E0000001
1000010101000000100000011
100C00000001000C000000001
1111111111111111111111111
